/images/background_1.jpg
####################
#b************f***b#
#*                *#
#*                *#
#*        3       *#
#*                *#
#b                b#
#*                *#
#*                *#
#*                *#
#*                *#
#s************f***f#
####################
