/images/bgtest.jpg
###############################
#      bf s   2 *   *  * * *   #
# # # #*# # #*#*# # # #*#*#*# #
#  p*     ***  *  2   * 2 * * #
# # # # # #*# # #*#*# # # # #*#
#f       2 p **  *  *   2     #
# # # # # # # # # #*# #*# # # #
#*  * 2    *  *      *        #
# # # # #*# # # #*#*# # # # # #
#*    **  *       *    2      #
# #*# # # # # # #*# # # # # # #
#           *   *  *          #
###############################