/images/bgtest.jpg
###############################
#      bf s  2 *   *  * * *   #
# # # #*# # #*#*# # # #*#*#*# #
#  p*     ***  *  2   * 2 * * #
# # # # # #*# # #*#*# # # # #*#
#f         p **  *  *   2     #
# # # # # # # # # #*# #*# # # #
#*  * 2    *  *      *        #
# # # # #*# # # #*#*# # # # # #
#*    **  *       *           #
# #*# # # # # # #*# # # # # # #
#           *   *  *          #
###############################