/images/background_1.jpg
####################
#b************f***b#
#*                *#
#*             3  *#
#*                p#
#*                *#
#b                b#
#*                *#
#*                *#
#*                *#
#*                *#
#s************f***f#
####################
